"filename", "language", "C++", "comment", "blank", "total"
"/Users/jens/Library/CloudStorage/OneDrive-Personal/ELSYS/TDT4102_C++/CHESS+/cell.cpp", "C++", 4, 0, 0, 4
"/Users/jens/Library/CloudStorage/OneDrive-Personal/ELSYS/TDT4102_C++/CHESS+/game.cpp", "C++", 61, 3, 10, 74
"/Users/jens/Library/CloudStorage/OneDrive-Personal/ELSYS/TDT4102_C++/CHESS+/game.h", "C++", 12, 0, 0, 12
"/Users/jens/Library/CloudStorage/OneDrive-Personal/ELSYS/TDT4102_C++/CHESS+/loadGame.cpp", "C++", 76, 1, 4, 81
"/Users/jens/Library/CloudStorage/OneDrive-Personal/ELSYS/TDT4102_C++/CHESS+/loadGame.h", "C++", 14, 0, 3, 17
"/Users/jens/Library/CloudStorage/OneDrive-Personal/ELSYS/TDT4102_C++/CHESS+/main.cpp", "C++", 1, 0, 0, 1
"/Users/jens/Library/CloudStorage/OneDrive-Personal/ELSYS/TDT4102_C++/CHESS+/mainWindow.cpp", "C++", -3, 0, 0, -3
"/Users/jens/Library/CloudStorage/OneDrive-Personal/ELSYS/TDT4102_C++/CHESS+/mainWindow.h", "C++", 5, -1, 0, 4
"/Users/jens/Library/CloudStorage/OneDrive-Personal/ELSYS/TDT4102_C++/CHESS+/pieces/types.h", "C++", 22, 1, 4, 27
"/Users/jens/Library/CloudStorage/OneDrive-Personal/ELSYS/TDT4102_C++/CHESS+/saveGame.cpp", "C++", 14, 3, 0, 17
"/Users/jens/Library/CloudStorage/OneDrive-Personal/ELSYS/TDT4102_C++/CHESS+/saveGame.h", "C++", 2, 0, 1, 3
"Total", "-", 208, 7, 22, 237